level1
#############
#  A        #
#  #      @ #
#   @       # 
#   o #  o  #
#############