level2
####     #####
#   #####    #
#     @  @   #
#  oo@# oo   #
## o  #@o@  ##
# o @# o   #
##   #@@  ##
#   # A###
#######





