#######
#  A  #
#  @  #
#  o  #
#######