          # # # # # # # #          # # # # #
       # #          #       # # # # #          #
   # #              #      @                     #
   #        #    # #          # # # # #    # # # #
# # o     o    o # #    # #      @                #
#           #                   # A   @         #     #
#           o  o  # # # #     # # # # @ #     #
# # # # # # # #       # #  @                    #
                                 # # # # #          # #
                                             # # # # #